#  ]          e   [#
####%###############
#          w       #
# 2##**########### #
#  ##  #$        # #
#      #         * #
#      #         # #
#      ########### #
#                  #
####################
?lemmingCount=5
?lemmingRequirement=5
?blastAntLimit=5


