##################  
#  #             #  
#  # ########### #
#1   #  w      # #
######%###%*%*%# #
#       +      #*###
#%%####%###    #   #
#              #   #
#            + [  $#
##~~~~~####~########
?lemmingCount=5
?lemmingRequirement=5
?blastAntLimit=5
