#########.##########
#########P##########
#    5w  p         #
#  ####%###*##**   #
#  #        #  #   #
#  #  #######  #   #
#  #  #$       *   #
#  #**##########   #
#                  #
####################
?lemmingCount=5
?lemmingRequirement=5
?blastAntLimit=5
