#  ]          e   [#
####%###############
#          !       #
# 2##**########### #
#  ##  #$        # #
#      #         * #
#      #         # #
#      ########### #
#                  #
####################
?lemmingCount=10
?lemmingRequirement=10
?blastAntLimit=3

