##########.#########
##########P#########
#         p        #
#  ####*#******#   #
#  #    #      #   #
#  *    *   $  #   #
#  #z   #      #   #
#  ###*#########   #
#      3           #
####################
?lemmingCount=5
?lemmingRequirement=5
?blastAntLimit=4
