####################
#    +             #
#    #         [   #
#    # !  1    #   #
#  #############   #
#              #$  #
#              [   #
#                  #
#                  #
####################