##################  
#  #             #  
#  # ########### #
#5   #  w      # #
######%###%*%*%# #
#       +      #*###
#%%####%###    #   #
#              #   #
#            + [  $#
##~~~~~####~########
?lemmingCount=5
?lemmingRequirement=5
?blastAntLimit=2
