####################
######             #
#######            #
#]    #            #
##### ##P###########
#     !            #
# #**%# p      #*##*
#     # #      #   #
#  #  # *      #  $#
###~~###############