####################
#        e  !      #
#   ############   #
#   #$     *  ##   #
#   #      #  ]*   #
#   #      # ###   #
#   #      #   #   #
#   ############   #
#        3##g      #
####~~~~~~~~~~~~~~~#