#########P##########
#                  #
#    5!  p         #
#  ####%###*##**   #
#  #        #  #   #
#  #  #######  #   #
#  #  #$       *   #
#  #**##########   #
#                  #
####################