####################
*#*#*#*#*#*#*#*#*#*#
#*#*#*#*#*#*#*#*#*#*
###     *   [**$*#*#
###    +#   _#**#*#*
###     #    ]  *#*#
###    x#       #*#*
###    6########*#*#
###     #*#*#*#*#*#*
########*#*#*#*#*#*#
?lemmingCount=5
?lemmingRequirement=5
?blastAntLimit=3
