####################
#      #           #
#      # ######### #
###6#### ######### #
#      # ######### #
#****%*# ######### #
#                  #
#       ############
#!                $#
####################
?lemmingCount=5
?lemmingRequirement=4
?blastAntLimit=3
